###############################
#.......# #...# #   # #.......#
#.###.#.# #.#.# # # # #.#.###.#
#.# #.#.# #.#.# # # # #.#.# #.#
#.###.#.###.#.### # ###.#.###.#
#...........#.....#...........#
#.###.##### # ### # #####.###.#
#.# #...#......#......#...# #.#
#.# #.#.#.     #     .#.#.# #.#
#.# #.#.#. ### # ### .#.#.# #.#
#.###...#. #   .   # .#...###.#
#.....#... # ##.## # ...#.....#
#####.###.   .....   .###.#####
#.....#... # ##.## # ...#.....#
#.###...#. #   .   # .#...###.#
#.# #.#.#. ### # ### .#.#.# #.#
#.# #.#.#.     #     .#.#.# #.#
#.# #...#......#......#...# #.#
#.###.##### # ### # #####.###.#
#...........#.....#...........#
#.###.#.### # ###.#.###.#.###.#
#.# #.#.# # # # #.#.# #.#.# #.#
#.###.#.# # # # #.#.# #.#.###.#
#.......# #   # #...# #.......#
###############################