#########################
#...........#...........#
#.###.#####.#.#####.###.#
#.# #.#   #.#.#   #.# #.#
#.###.#####.#.#####.###.#
#.......................#
#.###.#.##.###.##.#.###.#
#.....#.....#.....#.....#
#####.#####.#.#####.#####
#   #.#...........#.#    
#####.#.         .#.#####
#..... . ####### . .    #
#.#####. #     # .##### #
#..... . # #.# # . .    #
#####.#.   #.#   .#.#####
#   #.####.....####.#    
#####.#.   #.#   .#.#####
#    . . # #.# # . .....#
# #####. #     # .#####.#
#    . . ####### . .....#
#####.#.         .#.#####
#   #.#...........#.#    
#####.#####.#.#####.#####
#.....#.....#.....#.....#
#.###.#.##.###.##.#.###.#
#.......................#
#.###.#####.#.#####.###.#
#.# #.#   #.#.#   #.# #.#
#.###.#####.#.#####.###.#
#...........#...........#
#########################